11111111111111111111111111111
1000C0C0C0C0C0C0C0CPC0C0C0C01
1C0111001111001111001111000C1
10010100000100000100100100001
1C000100000100000100X001C00C1
1000M100111100111100000100001
1C000100X001000001000001C00C1
10000100000100000100M0010X001
1C00111011110011110000XE000C1
100C0C0C0C0C0C0C0C0C0C000C001
11111111111111111111111111111
