11111111111111111111111111111
1XP0C0C0C0C0C0C0C0C0C0C0C0CX1
1C0111001111001111001111000C1
1X0101000001000001001001000X1
1C0001000001000001000001C00C1
1X0001001111001111000001000X1
1C0001000001000001000001C00C1
1X0001000001000001000001000X1
1C001110111100111100000EC00C1
1X0C0C0C0C0C0C0C0C0C0C0C0C0X1
11111111111111111111111111111
