11111111111111111111111111111
1P000000000000000000000000001
10011100111100111100111100001
10010100000100000100100100001
100001000001000001000001C0001
10000100111100111100000100001
100001000001000001000001C0001
10000100000100000100000100001
10001110111100111100000EC0001
100C0C0C0C0C0C0C0C0C0C0C0C001
11111111111111111111111111111
