1111111111111111111111111111111111111111
1X001X100100101010C010010100100010001001
10000010010C00101000000101C010001C000C01
111110000101100011011000M000000110001001
1000001011001C10000X1001X100100011111011
10001X1001111110111111111111111010000001
11101111000C0000100010001001001010010001
10000001010010C0100010001001000000011101
1001000101C01000110111011101101010010001
1000000001101111100000000001001011111101
1110111111C01000111011101111011010010001
1C001000X100M0001XE0X0000001001010010001
1C00100001C010001111111101110010100M0001
11011110111011111000M0000001001011110111
10000P000100000010010X10100001101X000001
1111111101111111110111100011001010111111
10010100000001CC100100001001001010000001
1001000010100000111111111111011011111011
100001001010010010CC00000000CCX000000001
1111111111111111111111111111111111111111
